2;1
30000000000000000000000000000000000000033333333333
00000000000000000000000000000000000000000000000000
000I0000300000000000000000000000000000000000000000
00000000000000000000000000000000000003333000000000
00000000000000000000000000000000000000000000000000
00000000000000000000000000000000000000000000000000
00000000000000000000033330000000000000003000000000
00000003000000000000000000000000000000000000000000
00000000000000000000000000000000000000000000003000
00000000000000000000000000000000000000000000003000
00000000000000000000000000000000000000000000003000
00000000000000000000000003000000000000000000003000
00000000000000000000000000000000000000000000003000
00000000000000000000000000003333333333000000003000
00000000000000000000000000000000000000003000003000
00000000000000000030000000000000000000003000003000
00000000000000000000000000000000000000003000000000
00000003333000000000000000000000000000003000000000
00000000000000000000000000000000000333333000000000
00000000000000000000000000000000000000000000000000
00000000333333300000000000000000000000000000000000
3000000000000000000000000000000000000J000000000003
